A freelance spy is a great job. It pays well and you get to travel to new and interesting places. Unless you get caught, that part is not so great.

You tear open the unmarked envelope and unfold the mission briefing enclosed within: Infiltrate MegaCorp, gain access to the data centre, download the database.

So here you are, one week later - standing in the foyer of MegaCorp, under guise as a repairman.

Code Name Silver Steel
An Interactive Fiction by Special Agent
Release 1 / Serial number 170423 / Inform 7 build 6M62 (I6/v6.33 lib 6/12N) SD

Foyer
The spacious foyer of the MegaCorp building carries indistinguishable sounds along the sterile tiled floor and angular furniture, giving the impression of cold detachment.

You are standing by the reception desk in the centre of the room. The raised desk shields the small stature of the person behind it, oblivious to your presence.

To the north is an elevator, and a door beside it. 

(New players should type "help")

You can see a receptionist here.

>inventory
You are carrying:
  a job card
  an overall (being worn)
  a toolbox (closed)
  a wrist watch (being worn)

>x job card
This is a forged job card that states you are on-site to repair a faulty air conditioning unit. During the past week you gained access to the company intranet, and forged a matching maintenance record on their systems.

>show job card to receptionist
She takes the job card from you and scrutinizes it against her records.
"Fine", she says, handing you a clip-on tag. "Carry this with you at all times. The maintenance door is there", she points north. "Have a nice day".

>go north
(first opening the service entrance)
The receptionist eyes you from behind her fortress-desk as you open the door.

Maintenance Quarters
The room is well lit, however the grey plastered walls seem to drain the feng shui out of the carefully crafted maintenance quarters.

There is all manner of piping running along the roof. There is a panel in the north wall.

>drop toolbox
Dropped.

>open toolbox
You open the toolbox, revealing a screwdriver, a data disc and a suit.

>take all from toolbox
screwdriver: Taken.
data disc: Taken.
suit: Taken.

>wear the suit
You remove the overall and drop it on the floor.

You put on the suit.

>x panel
A gray steel panel. This one seems to cover a tunnel.

>open panel
The panel is screwed shut.

>turn screws
You loosen the screws using the screwdriver. The panel swings open.

>go north
Deftly, you step through the access tunnel and into the emergency fire escape stairwell. You ascend the stairs in the dim light and emerge surreptitiously in the administrative level of the building. Your arrival goes unnoticed.

Administration
You are standing against the wall in a large room. The space is divided into a dozen cubicles - people sitting inside their small cells. The room has the dull hum of a funeral parlour.

A cubicle is nearby. There is a doorway to the west, and an elevator to the north.

You can see a copy machine here.

>x cubicle
It is the closest cubicle to the copy machine.

In the cubicle are a security pass and an elderly man.

>x elderly man
He is an elderly man with receding brown hair. He seems preoccupied with his paperwork.

>x security pass
A security pass attached to a lanyard. The print on the card reads "elevator access".

>take security pass
It is out of reach. You need to enter the cubicle.

>enter cubicle
Not while the cubicle is occupied.

>x copy machine
It is a chunky piece of machinery with many tiny buttons. You notice stains on top of the machine.

>x stains
They are coffee ring stains, their location suggests it is where a cup is prone to spill. Somebody has a bad habit of putting their cups on the copy machine.

>go west
Breakroom
You are in a bare room without furniture. You guess MegaCorp doesn't want relaxed employees.

There is a pot of coffee on a counter here.

You can also see a coffee mug here.

>take mug
Taken.

>x pot
A pot of hot coffee.

>put coffee in mug
(the coffee pot in the coffee mug)
You fill the mug with hot coffee.

>go east
Administration
You are standing against the wall in a large room. The space is divided into a dozen cubicles - people sitting inside their small cells. The room has the dull hum of a funeral parlour.

A cubicle is nearby. The Breakroom is to the west, and an elevator to the north.

You can see a copy machine here.

>put mug on copy machine
You make sure nobody is watching, and quietly place the mug on the side of the copy machine.

>z
Time passes.

The elderly man gets up from his cubicle and walks to the copy machine. He shuffles his papers and pushes the buttons.

>enter cubicle
You get into the cubicle.

In the cubicle you can see a security pass.

Clang!
"What the hell!" the man curses, trying to save his coffee soaked pages.

>take security pass
Taken.

"Rats!" the man mumbles.

>exit
You get out of the cubicle.

Administration
You are standing against the wall in a large room. The space is divided into a dozen cubicles - people sitting inside their small cells. The room has the dull hum of a funeral parlour.

A cubicle is nearby. The Breakroom is to the west, and an elevator to the north.

You can see an elderly man and a copy machine (on which is a coffee mug) here.

The man shakes his wet pages angrily.

>go north
(first opening the elevator)
It seems to be locked.

"Rats!" the man mumbles.

>unlock elevator with security pass
You swipe the security pass across the elevator scanner, the door slides open and you step inside. You feel gravity reduce as you descend underground...

Data Centre
Rows upon rows of server racks fill this room, lengths of cabling run between them like neurons in a brain. The racks are interspersed with computer terminals, these are used to access various systems in the building.

A technician is here, working on a terminal.

You can also see a fire control terminal and a database terminal here.

>x fire control terminal
This terminal controls the fire detection and sprinkler systems of the building. You can log on terminal to use it.

>log on terminal
Which do you mean, the fire control terminal or the database terminal?

>fire
MegaCorp fire and safety control - Status: no fires - Activating fire drill

A siren rings out loudly, accompanied by a flashing red light in the ceiling.
The technician runs through the rows of servers, out of sight.

A siren blares.

>x database terminal
This terminal controls the information database. You notice a drive bay attached to it. You can log on terminal to use it.

A red light flashes in your eyes.

>x drive bay
A peripheral that is connected to the database terminal, used to copy files on and off the server. It has a slot to insert a data disc.

A red light flashes in your eyes.

>inventory
You are carrying:
  a security pass
  a suit (being worn)
  a data disc
  a screwdriver
  a maintenance tag
  a wrist watch (being worn)

A red light flashes in your eyes.

>put data disc in drive bay
You put the data disc into the drive bay.

A red light flashes in your eyes.

>log on terminal
Which do you mean, the fire control terminal or the database terminal?

>database
You download the files to the data disc in the drive bay, you have what you came for. Now to advance your own agenda: you upload a trojan horse into the server, and log off.

A red light flashes in your eyes.

>take data disc
You grab the data disc and make your escape by way of elevator to the roof. You reverse you suit jacket, turning it into a harness. A few minutes later, a glider soars overhead, a cable trailing below it. Executing a perfectly timed run, you grab the cable while hooking it into your suit harness - You soar silently out of sight.

Your mission was a success!

    *** The End ***

Would you like to RESTART, RESTORE a saved game, QUIT or UNDO the last command?

* * *

>attack receptionist
Stupidly, you aim your spy watch at the receptionist, a small dart shoots into her thigh and she collapses. Seconds later armed guards shove you against the wall. You are taken deep into the confines of the building, never to be seen again.

    *** Your mission and life end here ***

Would you like to RESTART, RESTORE a saved game, QUIT or UNDO the last command?

>undo
Foyer
[Previous turn undone.]

>kiss receptionist
The receptionist pushes you away and yells for "security!" In a matter of seconds you are restrained, searched, and led away to a dark cell deep under the building, never to be seen again.

    *** Your mission and life end here ***

Would you like to RESTART, RESTORE a saved game, QUIT or UNDO the last command?

>undo
Foyer
[Previous turn undone.]

>open door
"Sir!", the receptionist calls after you, "You can't enter there without clearance." (You could ignore her warning and go ahead, if you dare).

>open door
You ignore the receptionist's warning and enter the doorway, she raises an alarm and within seconds you are surrounded by armed guards. You are promptly led away deep into the confines of the the building, never to be heard from again.

    *** Your mission and life end here ***

Would you like to RESTART, RESTORE a saved game, QUIT or UNDO the last command?

>undo
Foyer
[Previous turn undone.]

>give job card to receptionist
She takes the job card from you and scrutinizes it against her records.
"Fine", she says, handing you a clip-on tag. "Carry this with you at all times. The maintenance door is there", she points north. "Have a nice day".

>go n
(first opening the service entrance)
The receptionist eyes you from behind her fortress-desk as you open the door.

Maintenance Quarters
The room is well lit, however the grey plastered walls seem to drain the feng shui out of the carefully crafted maintenance quarters.

There is all manner of piping running along the roof. There is a panel in the north wall.

>remove overall
You take off the overall.

>go s
You neglectfully walk into the Foyer without the repairman disguise. Not an unusual act in itself, except that the receptionist recognizes you and hastily calls for security. You are escorted deep into the confines of the building, never to be heard from again.

    *** Your mission and life end here ***

Would you like to RESTART, RESTORE a saved game, QUIT or UNDO the last command?

>undo
Maintenance Quarters
[Previous turn undone.]

>drop toolbox
Dropped.

* * *

>take all from toolbox
screwdriver: Taken.
data disc: Taken.
suit: Taken.

>wear suit
You put on the suit.

>turn screws
You loosen the screws using the screwdriver. The panel swings open.

>go n
Deftly, you step through the access tunnel and into the emergency fire escape stairwell. You ascend the stairs in the dim light and emerge surreptitiously in the administrative level of the building. Your arrival goes unnoticed.

Administration
You are standing against the wall in a large room. The space is divided into a dozen cubicles - people sitting inside their small cells. The room has the dull hum of a funeral parlour.

A cubicle is nearby. There is a doorway to the west, and an elevator to the north.

You can see a copy machine here.

>attack elderly man
Stupidly, you aim your spy watch at the elderly man, a small dart shoots into his thigh and he collapses. Seconds later armed guards shove you against the wall. You are taken deep into the confines of the building, never to be seen again.

    *** Your mission and life end here ***

Would you like to RESTART, RESTORE a saved game, QUIT or UNDO the last command?

>undo
Administration
[Previous turn undone.]

>purloin security pass
[Purloined.]

>unlock elevator with security pass
You swipe the security pass across the elevator scanner, the door slides open and you step inside. You feel gravity reduce as you descend underground...

Data Centre
Rows upon rows of server racks fill this room, lengths of cabling run between them like neurons in a brain. The racks are interspersed with computer terminals, these are used to access various systems in the building.

A technician is here, working on a terminal.

You can also see a fire control terminal and a database terminal here.

>put disc in drive
"What are you doing?", the tech asks you. "Who are you? Show me your security pass!"

She realizes that the pass does not belong to you, before you can react she trips an alarm. Armed men surround you within seconds and you are led away, never to be heard from again.

    *** Your mission and life end here ***

Would you like to RESTART, RESTORE a saved game, QUIT or UNDO the last command?